73
*
17
*
2
*
00-1-0
#
01-1-1
*
1111111111111111111111111111111111111111111111111111111111111111111111111
1000000000000000100010000000000010000000100000000000000000000000000010001
1111111111111000100011111000111110001000111111111000111110001111100010001
1000000010000000100000001000100000001000000010001000100010000000100010001
1111100010001111100011111000100011111111100010001000100011111000100010001
1000000010001000000000001000000000000000100010001000000010001000100010001
1000111110001000111110001111111110001111100010001111100010001000100010001
1000000010000000100010000000100000001000000010000000100000001000100000001
1000100010001111100011111000111110001000111111111000111110001000111111111
1000100000001000000010001000000010001000000010000000100000001000000000001
1000111111111000100010001111100011111111100010001111111111111111111110001
1000100000000000100010000000100000001000000010000000100000000000100000001
1000100011111111111111111000111110001000100011111000100011111000100010001
1000100000000000100000000000100000001000100010000000100000001000100010001
1000100011111000100011111000111111111000100010001111111110001000100010001
1000000010000000000000001000000000000000100000000000000000001000000010001
1111111111111111111111111111111111111111111111111111111111111111111111111
*
01 01 01 01 01 01 01 01 01 01 01 01 01 01 01 01 01 01 01 01 01 01 01 01 01 01 01 01 01 01 01 01 01 01 01 01 01 01 01 01 01 01 01 01 01 01 01 01 01 01 01 01 01 01 01 01 01 01 01 01 01 01 01 01 01 01 01 01 01 01 01 01 01 
01 00 00 00 00 00 00 00 00 00 00 00 00 00 00 00 01 00 00 00 01 00 00 00 00 00 00 00 00 00 00 00 01 00 00 00 00 00 00 00 01 00 00 00 00 00 00 00 00 00 00 00 00 00 00 00 00 00 00 00 00 00 00 00 00 00 00 00 01 00 00 00 01 
01 01 01 01 01 01 01 01 01 01 01 01 01 00 00 00 01 00 00 00 01 01 01 01 01 00 00 00 01 01 01 01 01 00 00 00 01 00 00 00 01 01 01 01 01 01 01 01 01 00 00 00 01 01 01 01 01 00 00 00 01 01 01 01 01 00 00 00 01 00 00 00 01 
01 00 00 00 00 00 00 00 01 00 00 00 00 00 00 00 01 00 00 00 00 00 00 00 01 00 00 00 01 00 00 00 00 00 00 00 01 00 00 00 00 00 00 00 01 00 00 00 01 00 00 00 01 00 00 00 01 00 00 00 00 00 00 00 01 00 00 00 01 00 00 00 01 
01 01 01 01 01 00 00 00 01 00 00 00 01 01 01 01 01 00 00 00 01 01 01 01 01 00 00 00 01 00 00 00 01 01 01 01 01 01 01 01 01 00 00 00 01 00 00 00 01 00 00 00 01 00 00 00 01 01 01 01 01 00 00 00 01 00 00 00 01 00 00 00 01 
01 00 00 00 00 00 00 00 01 00 00 00 01 00 00 00 00 00 00 00 00 00 00 00 01 00 00 00 00 00 00 00 00 00 00 00 00 00 00 00 01 00 00 00 01 00 00 00 01 00 00 00 00 00 00 00 01 00 00 00 01 00 00 00 01 00 00 00 01 00 00 00 01 
01 00 00 00 01 01 01 01 01 00 00 00 01 00 00 00 01 01 01 01 01 00 00 00 01 01 01 01 01 01 01 01 01 00 00 00 01 01 01 01 01 00 00 00 01 00 00 00 01 01 01 01 01 00 00 00 01 00 00 00 01 00 00 00 01 00 00 00 01 00 00 00 01 
01 00 00 00 00 00 00 00 01 00 00 00 00 00 00 00 01 00 00 00 01 00 00 00 00 00 00 00 01 00 00 00 00 00 00 00 01 00 00 00 00 00 00 00 01 00 00 00 00 00 00 00 01 00 00 00 00 00 00 00 01 00 00 00 01 00 00 00 00 00 00 00 01 
01 00 00 00 01 00 00 00 01 00 00 00 01 01 01 01 01 00 00 00 01 01 01 01 01 00 00 00 01 01 01 01 01 00 00 00 01 00 00 00 01 01 01 01 01 01 01 01 01 00 00 00 01 01 01 01 01 00 00 00 01 00 00 00 01 01 01 01 01 01 01 01 01 
01 00 00 00 01 00 00 00 00 00 00 00 01 00 00 00 00 00 00 00 01 00 00 00 01 00 00 00 00 00 00 00 01 00 00 00 01 00 00 00 00 00 00 00 01 00 00 00 00 00 00 00 01 00 00 00 00 00 00 00 01 00 00 00 00 00 00 00 00 00 00 00 01 
01 00 00 00 01 01 01 01 01 01 01 01 01 00 00 00 01 00 00 00 01 00 00 00 01 01 01 01 01 00 00 00 01 01 01 01 01 01 01 01 01 00 00 00 01 00 00 00 01 01 01 01 01 01 01 01 01 01 01 01 01 01 01 01 01 01 01 01 01 00 00 00 01 
01 00 00 00 01 00 00 00 00 00 00 00 00 00 00 00 01 00 00 00 01 00 00 00 00 00 00 00 01 00 00 00 00 00 00 00 01 00 00 00 00 00 00 00 01 00 00 00 00 00 00 00 01 00 00 00 00 00 00 00 00 00 00 00 01 00 00 00 00 00 00 00 01 
01 00 00 00 01 00 00 00 01 01 01 01 01 01 01 01 01 01 01 01 01 01 01 01 01 00 00 00 01 01 01 01 01 00 00 00 01 00 00 00 01 00 00 00 01 01 01 01 01 00 00 00 01 00 00 00 01 01 01 01 01 00 00 00 01 00 00 00 01 00 00 00 01 
01 00 00 00 01 00 00 00 00 00 00 00 00 00 00 00 01 00 00 00 00 00 00 00 00 00 00 00 01 00 00 00 00 00 00 00 01 00 00 00 01 00 00 00 01 00 00 00 00 00 00 00 01 00 00 00 00 00 00 00 01 00 00 00 01 00 00 00 01 00 00 00 01 
01 00 00 00 01 00 00 00 01 01 01 01 01 00 00 00 01 00 00 00 01 01 01 01 01 00 00 00 01 01 01 01 01 01 01 01 01 00 00 00 01 00 00 00 01 00 00 00 01 01 01 01 01 01 01 01 01 00 00 00 01 00 00 00 01 00 00 00 01 00 00 00 01 
01 00 00 00 00 00 00 00 01 00 00 00 00 00 00 00 00 00 00 00 00 00 00 00 01 00 00 00 00 00 00 00 00 00 00 00 00 00 00 00 01 00 00 00 00 00 00 00 00 00 00 00 00 00 00 00 00 00 00 00 01 00 00 00 00 00 00 00 01 00 00 00 01 
01 01 01 01 01 01 01 01 01 01 01 01 01 01 01 01 01 01 01 01 01 01 01 01 01 01 01 01 01 01 01 01 01 01 01 01 01 01 01 01 01 01 01 01 01 01 01 01 01 01 01 01 01 01 01 01 01 01 01 01 01 01 01 01 01 01 01 01 01 01 01 01 01   
*
0-0
*
70-15-tempMap.txt
*
7,7:1
#
6,8:1
#
15,2:1
#
19,1:1
#
2,6:1
#
7,11:1
#
2,13:1
#
15,13:1
#
21,9:1
#
20,13:1
#
26,13:1
#
36,15:1
#
37,2:1
#
38,11:1
#
39,7:1
#
38,8:1
#
41,12:1
#
43,4:1
#
38,2:1
#
43,13:1
#
50,3:1
#
54,12:1
#
61,15:1
#
64,15:1
#
65,1:1
#
68,7:1
#
70,3:1
#
69,9:1
#
71,10:1
#
69,1:1
#
22,10:1
#
24,11:1
#
27,9:1
#
35,12:1
#
43,15:1
#
45,14:1
#
50,15:1
#
56,13:1
#
30,11:1
#
54,5:1
*
2,12:1
#
7,14:2
#
13,9:1
#
14,10:2
#
15,11:1
#
27,5:2
#
25,5:1
#
51,9:1
#
55,3:2
#
55,7:1
#
58,1:1
#
66,4:1
#
70,2:1
#
71,1:2
#
70,2:1
#
69,2:2
#
66,13:1
#
50,8:1
#
46,14:1
#
29,7:1
#
31,1:2
#
67,1:2
#
21,1:2
#
41,1:1
#
21,9:2
#
22,10:2
#
23,11:2