73
*
17
*
1
*
00-1-0
#
01-1-1
*
1111111111111111111111111111111111111111111111111111111111111111111111111
1000100000001000000000000000000010001000000000000000000000001000000000001
1000100010001111111110001111100010001000100011111000111110001000100011111
1000100010000000000010000000100010000000100000001000100010001000100000001
1000100010001111100011111111100011111111100010001000100010001000111110001
1000000010000000100010000000000000000000100010001000100010001000100000001
1111100011111000100010001111111111111000111110001000100010001000100010001
1000100000001000100000000000000000001000100000001000100010001000100010001
1000111110001000111110001111111110001000100011111000100010001111100010001
1000100000001000100010001000000010001000000010000000100000000000000010001
1000100011111000100010001111100010001111111110001111111111111111111110001
1000100010001000000010000000000010001000000010000000000000001000000010001
1000100010001111111111111111111111111000100011111111111110001000111110001
1000000010000000000010000000000010000000100000000000100000001000100000001
1111111110001111100010001000100010001111111110001111100011111000100011111
1000000000000000100000001000100000000000000010000000000010000000000000001
1111111111111111111111111111111111111111111111111111111111111111111111111
*
01 01 01 01 01 01 01 01 01 01 01 01 01 01 01 01 01 01 01 01 01 01 01 01 01 01 01 01 01 01 01 01 01 01 01 01 01 01 01 01 01 01 01 01 01 01 01 01 01 01 01 01 01 01 01 01 01 01 01 01 01 01 01 01 01 01 01 01 01 01 01 01 01 
01 00 00 00 01 00 00 00 00 00 00 00 01 00 00 00 00 00 00 00 00 00 00 00 00 00 00 00 00 00 00 00 01 00 00 00 01 00 00 00 00 00 00 00 00 00 00 00 00 00 00 00 00 00 00 00 00 00 00 00 01 00 00 00 00 00 00 00 00 00 00 00 01 
01 00 00 00 01 00 00 00 01 00 00 00 01 01 01 01 01 01 01 01 01 00 00 00 01 01 01 01 01 00 00 00 01 00 00 00 01 00 00 00 01 00 00 00 01 01 01 01 01 00 00 00 01 01 01 01 01 00 00 00 01 00 00 00 01 00 00 00 01 01 01 01 01 
01 00 00 00 01 00 00 00 01 00 00 00 00 00 00 00 00 00 00 00 01 00 00 00 00 00 00 00 01 00 00 00 01 00 00 00 00 00 00 00 01 00 00 00 00 00 00 00 01 00 00 00 01 00 00 00 01 00 00 00 01 00 00 00 01 00 00 00 00 00 00 00 01 
01 00 00 00 01 00 00 00 01 00 00 00 01 01 01 01 01 00 00 00 01 01 01 01 01 01 01 01 01 00 00 00 01 01 01 01 01 01 01 01 01 00 00 00 01 00 00 00 01 00 00 00 01 00 00 00 01 00 00 00 01 00 00 00 01 01 01 01 01 00 00 00 01 
01 00 00 00 00 00 00 00 01 00 00 00 00 00 00 00 01 00 00 00 01 00 00 00 00 00 00 00 00 00 00 00 00 00 00 00 00 00 00 00 01 00 00 00 01 00 00 00 01 00 00 00 01 00 00 00 01 00 00 00 01 00 00 00 01 00 00 00 00 00 00 00 01 
01 01 01 01 01 00 00 00 01 01 01 01 01 00 00 00 01 00 00 00 01 00 00 00 01 01 01 01 01 01 01 01 01 01 01 01 01 00 00 00 01 01 01 01 01 00 00 00 01 00 00 00 01 00 00 00 01 00 00 00 01 00 00 00 01 00 00 00 01 00 00 00 01 
01 00 00 00 01 00 00 00 00 00 00 00 01 00 00 00 01 00 00 00 00 00 00 00 00 00 00 00 00 00 00 00 00 00 00 00 01 00 00 00 01 00 00 00 00 00 00 00 01 00 00 00 01 00 00 00 01 00 00 00 01 00 00 00 01 00 00 00 01 00 00 00 01 
01 00 00 00 01 01 01 01 01 00 00 00 01 00 00 00 01 01 01 01 01 00 00 00 01 01 01 01 01 01 01 01 01 00 00 00 01 00 00 00 01 00 00 00 01 01 01 01 01 00 00 00 01 00 00 00 01 00 00 00 01 01 01 01 01 00 00 00 01 00 00 00 01 
01 00 00 00 01 00 00 00 00 00 00 00 01 00 00 00 01 00 00 00 01 00 00 00 01 00 00 00 00 00 00 00 01 00 00 00 01 00 00 00 00 00 00 00 01 00 00 00 00 00 00 00 01 00 00 00 00 00 00 00 00 00 00 00 00 00 00 00 01 00 00 00 01 
01 00 00 00 01 00 00 00 01 01 01 01 01 00 00 00 01 00 00 00 01 00 00 00 01 01 01 01 01 00 00 00 01 00 00 00 01 01 01 01 01 01 01 01 01 00 00 00 01 01 01 01 01 01 01 01 01 01 01 01 01 01 01 01 01 01 01 01 01 00 00 00 01 
01 00 00 00 01 00 00 00 01 00 00 00 01 00 00 00 00 00 00 00 01 00 00 00 00 00 00 00 00 00 00 00 01 00 00 00 01 00 00 00 00 00 00 00 01 00 00 00 00 00 00 00 00 00 00 00 00 00 00 00 01 00 00 00 00 00 00 00 01 00 00 00 01 
01 00 00 00 01 00 00 00 01 00 00 00 01 01 01 01 01 01 01 01 01 01 01 01 01 01 01 01 01 01 01 01 01 01 01 01 01 00 00 00 01 00 00 00 01 01 01 01 01 01 01 01 01 01 01 01 01 00 00 00 01 00 00 00 01 01 01 01 01 00 00 00 01 
01 00 00 00 00 00 00 00 01 00 00 00 00 00 00 00 00 00 00 00 01 00 00 00 00 00 00 00 00 00 00 00 01 00 00 00 00 00 00 00 01 00 00 00 00 00 00 00 00 00 00 00 01 00 00 00 00 00 00 00 01 00 00 00 01 00 00 00 00 00 00 00 01 
01 01 01 01 01 01 01 01 01 00 00 00 01 01 01 01 01 00 00 00 01 00 00 00 01 00 00 00 01 00 00 00 01 00 00 00 01 01 01 01 01 01 01 01 01 00 00 00 01 01 01 01 01 00 00 00 01 01 01 01 01 00 00 00 01 00 00 00 01 01 01 01 01 
01 00 00 00 00 00 00 00 00 00 00 00 00 00 00 00 01 00 00 00 00 00 00 00 01 00 00 00 01 00 00 00 00 00 00 00 00 00 00 00 00 00 00 00 01 00 00 00 00 00 00 00 00 00 00 00 01 00 00 00 00 00 00 00 00 00 00 00 00 00 00 00 01 
01 01 01 01 01 01 01 01 01 01 01 01 01 01 01 01 01 01 01 01 01 01 01 01 01 01 01 01 01 01 01 01 01 01 01 01 01 01 01 01 01 01 01 01 01 01 01 01 01 01 01 01 01 01 01 01 01 01 01 01 01 01 01 01 01 01 01 01 01 01 01 01 01  
*
1-1
*
70-15-02.txt
*
7,7:1
#
8,1:1
#
1,8:1
#
3,10:1
#
24,1:1
#
18,3:1
#
19,7:1
#
6,10:1
#
10,12:1
#
18,13:1
#
30,1:1
#
38,6:1
#
39,5:1
#
42,1:1
#
46,1:1
#
52,1:1
#
62,7:1
#
54,14:1
#
58,11:1
#
67,2:1
#
68,1:1
#
70,4:1
#
71,10:1
#
64,15:1
#
66,13:1
#
59,15:1
*
3,5:1
#
15,7:1
#
27,14:1
#
33,8:1
#
49,8:1
#
51,8:2
#
59,12:1
#
2,7:2